360安全卫士=>360tray.exe
360杀毒=>360sd.exe
a-squared杀毒=>a2guard.exe
Lavasoft杀毒=>ad-watch.exe
The Cleaner杀毒=>cleaner8.exe
vb32杀毒=>vba32lder.exe
Mongoosa杀毒=>MongoosaGUI.exe
Coranti2012杀毒=>CorantiControlCenter32.exe
F-PROT杀毒=>F-PROT.EXE
CMC杀毒=>CMCTrayIcon.exe
K7杀毒=>K7TSecurity.exe
UnThreat杀毒=>UnThreat.exe
Shield Antivirus杀毒=>CKSoftShiedAntivirus4.exe
VIRUSfighter杀毒=>AVWatchService.exe
ArcaVir杀毒=>ArcaTasksService.exe
Immunet杀毒=>iptray.exe
PSafe杀毒=>PSafeSysTray.exe
nProtect杀毒=>nspupsvc.exe
SpywareTerminator杀毒=>SpywareTerminatorShield.exe
Bkav杀毒=>BKavService.exe
Microsoft Security Essentials=>MsMpEng.exe
VIPRE=>SBAMSvc.exe
Norton杀毒=>ccSvcHst.exe
冰岛=>f-secure.exe
卡巴斯基=>avp.exe
江民杀毒=>KvMonXP.exe
瑞星杀毒=>RavMonD.exe
麦咖啡=>Mcshield.exe
NOD32=>egui.exe
金山毒霸=>kxetray.exe
可牛杀毒=>knsdtray.exe
Avira(小红伞)=>avcenter.exe
Avast网络安全=>ashDisp.exe
诺顿杀毒=>rtvscan.exe
金山卫士=>ksafe.exe
QQ电脑管家=>QQPCRTP.exe
流量矿石=>Miner.exe
韩国胶囊=>AYAgent.aye
安博士=>patray.exe
安博士V3=>V3Svc.exe
AVG杀毒=>avgwdsvc.exe
赛门铁克=>ccSetMgr.exe
QUICK HEAL杀毒=>QUHLPSVC.EXE
微软杀毒=>mssecess.exe
Sophos杀毒=>SavProgress.exe
F-Secure杀毒=>fsavgui.exe
比特梵德=>vsserv.exe
熊猫卫士=>remupd.exe
飞塔=>FortiTray.exe
安全狗=>safedog.exe
木马克星=>parmor.exe
贝壳云安全=>beikesan.exe
金山网盾=>KSWebShield.exe
木马猎手=>TrojanHunter.exe
巨盾网游安全盾=>GG.exe
绿鹰安全精灵=>adam.exe
超级巡警=>AST.exe
墨者安全专家=>ananwidget.exe
GData=>AVK.exe
Symantec Norton=>ccapp.exe
AVG Anti-Virus=>avg.exe
Dr.web=>spidernt.exe
Mcafee=>Mcshield.exe
Avira Antivir=>avgaurd.exe
F-Prot AntiVirus=>F-PROT.exe
ZoneAlarm=>vsmon.exe
Kaspersky=>avp.exee
Comodo=>cpf.exe
Outpost Firewall=>outpost.exe
瑞星防火墙=>rfwmain.exe
金山网镖=>kpfwtray.exe
风云防火墙=>FYFireWall.exe
微点主动防御=>MPMon.exe
天网防火墙=>pfw.exe
发现S-U=>ServUDaemon.exe
百度杀软=>BaiduSdSvc.exe
火绒=>hipstray.exe
趋势科技=>ntrtscan.exe
QQ=>QQ.exe
SangforVpn(已连接上VPN)=>SangforServiceClient.exe
SangforVpn=>sangforPW.exe
ProcessHacker(调试机?)=>ProcessHacker.exe
IDA(调试机?)=>ida.exe
IDAx64(调试机?)=>ida64.exe
VM虚拟机=>vmtoolsd.exe